#############
#     .#   .#
# B BB      #
#     @###  #
######## #.##
         ###