####
#  ###
#    #
# B  #
### ###
# B B #
#..&..#
#  B  #
###  ##
  ####