    #####
    #   #
    #B  #
  ###   ###
  #       #
### # ### #     ######
#   # ### #######  ..#
# B  B              X#
##### #### #&####   .#
    #      ###  ######
    ########