#############
#     .#    #
#    B      #
#     @######
########